*****    *****    *****
*   * ** *   * ** *   * -> END
*****    *****    *****
  *        *
  *        *
*****    *****    
*   * ** *   *
*****    *****
           *
           *
         *****    *****
         *   * ** *   *
         *****    *****
           ^
           |
         START